R 10000 10000
NO              ressources/bricks/brick_painted.xpm
SO ressources/bricks/ground_root.xpm
WE ressources/bricks/brick_grass.xpm
EA ressources/bricks/wood_gate.xpm

S ressources/pokemon/pikachu.xpm
F ressources/bricks/grass_floor.xpm
C 115,  192,232

        11111111111111111111111110001
        1000000200110000000000001E
        1011000001110000002000001
        10010000000000000000000011111
1111111110110020011100000000002000001
1020000000110000011101111111111111111
11110111111111011100000010001
11110111111111011101010010001                   
11000000110101011100000000001
1000200000000000000000001000
10000000000000001101010010201
1100000111012101111101111000111		
11112111 1112101 101111010001
11111111 1111111 111111111111