R 640 480
NO ./bricks/handpaintedwall2.xpm
SO ./bricks/ESCAPE--Wild-Hunt--Team-_Old-School_-Page-3.xpm
WE ./bricks/Hand-Painted-Textures_-Ulrick-Wery.xpm
EA ./bricks/Archive-»-Texture-Painting.xpm

S ./pok.txt
F 115,232,138
C 115,192,232

111111111111111
120S00020000021
110001000010001
102011002000001
111120000000001
111111111111111