R 640 480
NO ./path_to_the_north_texture
SO ./path_to_the_south_texture
WE ./path_to_the_west_texture
EA ./path_to_the_east_texture

S ./path_to_the_sprite_texture
F 220,100,0
C 225,30,0

11111111111
10000000011
10011110101
10000000101
10101011101
10100000101
11100N01111
10100000101
10100000101
10001010001
11111111111