R 1080 720
NO ./bricks/brick_painted.xpm
SO ./bricks/ground_root.xpm
WE ./bricks/brick_grass.xpm
EA ./bricks/wood_gate.xpm

S ./pokemon/mew.xpm
F ./bricks/grass_floor.xpm
C 115,192,232

111111111111111111111111111111111111111111111
101000001000000000100000001000100000100000001
101010101111101111110110111110111011101111111
100010101000100010000010000010000010100010001
111111101011111011111110101111011110101010111
100000100000001010100000100010000000001000101
111110111011101010101111111010111111101111101
101010000000100000101000100000001010000000001
101000101111110111101110111011111010111111101
101010101000000010001000100000100010001010001
101111101011111111101110111101101110111011101
100000001010100000001010100000000010101010101
101111101010110110101010111010111011101010101
100010101010000010101010101010001010001000001
111110111010111111100010101111111010101110111
101010100010100000101000100000101010100000001
100010101111101010111111111110101011111010111
101010001000001010100000101000000000100010001
111011101101111011101111101111110111111110111
101000000000101000100000000010000010001010001
101011111110101111101111111011101011100011111
100010000010100000001000101000101000001000001
111010101010101011111110100011101011111010111
101010101000001000000000101000001010001010101
101011111110101011111011111111111110111110101
101000001010101010001000000000100000000000001
101010111011101110101110101111111011101010101
100010001000101010100000101000100000101010101
101110111011101010111111111010111010101011111
101010100000000010100010000010001010101000101
101011101111101011101N10101110111111111010101
101000000010001010001000100010100010000010101
111111111011111110101011111011110110101011101
100000000010000000100010100010100000101000001
101111101011111010101110111110101111111011101
101000101010100010100000001000100010000000101
101011111110101011101010111011101111101011101
100000001010001010101010000010001000101010001
111011101010111110101111111010111101111010101
100000101000001000101002001010000200100010101
101110111110111110101110111011101110111011111
1000100000101000102000000012000000100010001S1
101011111110111010111010111111121110101111101
101000001000001000100010002000101000102000001
111111111111111111111111111111111111111111111