R 640 480
NO ./fake_sky.xpm
SO ./bricks/bricks_grey.xpm
WE ./bricks/bricks_white.xpm
EA ./bricks/bricks_red.xpm

S ./path_to_the_sprite_texture
F 220,100,0
C 225,30,0

111111111
100S00001
110001001
100011001
111100001
111111111