R 1080 720
NO ./bricks/brick_painted.xpm
SO ./bricks/ground_root.xpm
WE ./bricks/brick_grass.xpm
EA ./bricks/wood_gate.xpm

S ./pokemon/papillusion.xpm
F ./bricks/grass_floor.xpm
C 115,192,232

1111111111111111111111111111111
1000100010100010000010000000001
1011111000111011101110111011111
1000001010101000000010100000101
1110111110001011111011101010101
1000001010101000001000001010001
1110101011100011111010111011101
1010100000101000100010101000101
1011111110111110111110101010111
1000001010001010100010001010001
1111101010111011101010111011111
1010000010000000101010001000101
1010101110111101101000101010101
1010101010100000001010101010101
1010111011111110101110111011101
1000001010101010101000001000101
1110111010001010111011101110101
1010001000100010100010100010001
1011011110111010111110101110111
1000001000100000101000001000001
1010111110101010101110111111101
1010001010101010000010101010001
1011101011111011101011101010111
1010001000100010001000101010001
1011011110111011101011101011011
1010000010100000101000100002001
1110101110111111101111101111101
1010100000000000001020001010201
1011111010101111101111111010111
10000000101000100000001E0000021
1111111111111111111111111111111