R 102423 64045
NO ./bricks/brick_painted.xpm
SO ./bricks/ground_root.xpm
WE ./bricks/brick_grass.xpm
EA ./bricks/wood_gate.xpm

S ./pokemon/localisation.xpm
F ./bricks/grass_floor.xpm
C 115,192,232

1111111111111111111111111111111
1002100N10100010000010000000001
1011111000111011101110111011111
10000010101010E0000010100000101
1110111110001011111011101010101
1000001010101000001002001010001
111N101011100011111010111011101
1010100020101002100010101000101
1011111110111110111110101010111
1000001010001012100010001010201
111110101N111011101012111011111
1010000010000000101010001020101
1010101110111101101000101010101
1010101010100000001010101010101
1010111011111110101112111011101
1002001010101010101000001000101
1110111010101010111011101110101
1010001000100010100010102010001
1011011110111010111110101110111
1000001000100000101000001020001
1010111110101010121110111111101
1010001010101010000012101010201
1011101011111011101011101210111
1010001020100010001000101010001
1011011110111011121011101011011
1010000010100000101000100002001
1110101110111111121111101111101
1010102000002000001020001010201
1011111010101111101111111010111
1020000010120012000000100000021
1111111111111111111111111111111