R 400 200

NO ./assets/images/face_north.xpm
SO ./assets/images/face_south.xpm
WE ./assets/images/face_west.xpm
EA ./assets/images/face_east.xpm

S2 ./assets/images/baril.xpm

F 145, 65, 98
C 24, 89, 150

111111111111111111111111111111
10000000000000000000000000011
100000000000000000000000000001
100000000000000000000000000001
100000000000000000000000000001
100000000000020000000000000001
100000000000000000000000000001
100000000000000000000000000001
1000000000000N0000000000000001
100000000000000000000000000001
100000000000000000000000000001
100000000000000000000000000001
100000000000000000000000000001
100000000000000000000000000001
100000000000000000000000000001
100000000000000000000000000001
100000000000000000000000000001
110101010101010101010101010101
111111111111111111111111111111